b.a..01..S
c..d032...
0f.e..0..0
...0....0.
.F......0.
.09.....8.
.......0..
.0.0..0670
0.........
.00..4.50.